                                  
┌─────────────┐                   
│·············│                   
└─────────────┘                   
                                  
                ┌────────────────┐
                │················│
                │················│
                │················│
                └────────────────┘
                                  
                                  
     ┌───────────────────────────┐
     │···························│
     │···························│
     │···························│
     └────┐················┌─────┘
          │················│      
   ┌──────┘················│      
   │·······················│      
   └───────────────────────┘      