                                      
                        ┌────────────┐
                        │············│
    ┌───────────────────┘·┌──────────┘
    │·····················│           
    │·····················│           
    │!····················│           
    └─────────────────────┘           